#####################################################
#...................................................#
#.....................................###...........#
#...........>..........................#............#
#......................................#............#
#.....$................................#............#
#.....................................###...........#
#####################################################
