#####################################################
#....<..............................................#
#.....................................###...........#
#...........>..........................#............#
#.....................................#............#
#.....$................................#............#
#.....................................###...........#
#####################################################
